##########
#....E...#
#..P.....#
#.....O..#
##########
