##########
#E...E...#
#..P.....#
#.....O..#
##########
